LEVEL 2 13 31
###############################
#                             #
#                             #
#                             #
# # # # # #*# # #*#*# # # # #*#
#                             #
# # # # # # #1# # #*# #*# # # #
#*# #    2 *  *    1 *   3    #
# # # # #*# # # #*#*# # # # # #
#*# # **5 *       *     p 4   #
# #*# # # # # # #*# # # # # # #
#   #       *   *  *          #
###############################
