LEVEL 1 13 31
###############################
#p  bfs** *    *   *  * * *   #
# # # #*# # #*#*# # # #*#*#*# #
#1#x* 1   ***  *      *   * * #
# # # # # #*# # #*#*# # # # #*#
#f# #        **  *  *         #
# # # # # # # # # #*# #*# # # #
#*# #      *  *      *        #
# # # # #*# # # #*#*# # # # # #
#*# # **  *       *           #
# #*# # # # # # #*# # # # # # #
#   #       *   *  *          #
###############################
