LEVEL 1 13 31
###############################
#p  bfs** *    *   *  * * *   #
# # # #*# # #*#*# # # #*#*#*# #
#   *     ***  *      *   * * #
# # # # # #*# # #*#*# # # # #*#
#f#          **  *  *     x   #
# # # # # # #1# # #*# #*# # # #
#*# #      *  *      *        #
# # # # #*# # # #*#*# # # # # #
#*# # **  *       *           #
# #*# # # # # # #*# # # # # # #
#   #       *   *  *          #
###############################
