LEVEL 2 13 31
###############################
# p *               sfbb      #
#  ############ ###########   #
#                  1          #
# #*# # # #*# # #*#*# # # # #*#
#  *                          #
# # # # # # # # # #*# #*# # # #
#*# #     *  *      *  *1 *   #
# # # # #*# # #*#*#*# # #*# # #
#*# # **5 * x *2* *     * 4** #
# #*# # # # # #*#*# # # # # # #
#   #       *   *  *          #
###############################
