LEVEL 2 13 31
###############################
#                             #
#                             #
#                             #
# # # # # #*# # #*#*# # # # #*#
#                             #
# # # # # # #1# # #*# #*# # # #
#*# #     *  *      *   3     #
# # # # #*# # # #*#*# # # # # #
#*# # **5 * x  2  *     p 4   #
# #*# # # # # # #*# # # # # # #
#   #       *   *  *          #
###############################
