LEVEL 1 13 31
###############################
#   bfs** *    *  1*  * * *   #
# # # #*# # #*#*# # # #*#*#*# #
#   *                 *   * * #
# # # # # #*# # #*#*# # # # #*#
#f#           2           x   #
# # # # # # # # # #*# #*# # # #
#*# #                         #
# # # # #*# # # #*#*# # # # # #
#*# # **  *                   #
# #*# # # # # # #*# # # # # # #
#   #       *   p  *          #
###############################
