1 13 31
###############################
#p  bfs** *  1 * 2 *  * * *   #
# # # #*# # #*#*# # # #*#*#*# #
#1#x*1    ***  *  1   * 2 * * #
#1# # # # #*# # #*#*# # # # #*#
#f# #      x **  *  *   1     #
# # # # # # # # # #*# #*# # # #
#*# #      *  *      *        #
# # # # #*# # # #*#*# # # # # #
#*# # **  *       *           #
# #*# # # # # # #*# # # # # # #
#   #       *   *  *          #
###############################
