LEVEL 1 13 31
###############################
# p bfs** *    *   *  * * *   #
# # # #*#f# #*#*# # # #*#*#*# #
#     b     1             * * #
# # #s# # #*# # #*#*# # # # #*#
# #      1    *x              #
#*# # # # # ##  # #*# #*# # # #
#*# #  1# # ###               #
# # # # ### ##  #*#*# # # # # #
#*# # **  *                   #
# #*# # # # # # #*# # # # # # #
#   #       *      *          #
###############################
