LEVEL 2 13 31
###############################
# p *                         #
#  ############ ###########   #
#                             #
# # # # # #*# # #*#*# # # # #*#
#                             #
# # # # # # #1# # #*# #*# # # #
#*# #     *  *      *  *3 *   #
# # # # #*# # #*#*#*# # #*# # #
#*# # **5 * x *2* *     * 4** #
# #*# # # # # #*#*# # # # # # #
#   #       *   *  *          #
###############################
