LEVEL 1 13 31
###############################
#3  bfs** *    *  1*  * * *   #
#5# # #*# # #*#*# # # #*#*#*# #
#   *                 *   * * #
# # # # # #*# # #*#*# # # # #*#
#f#                       x   #
# # # # # # # # # #*# #*# # # #
#*# #        2                #
# # # # #*# # # #*#*# # # # #4#
#*# # **  *                   #
# #*# # # # # # #*# # # # # # #
#   #       *   p  *          #
###############################
