LEVEL 1 13 31
###############################
# p bfs** *    *   *  * * *   #
# # # #*# # #*#*# # # #*#*#*# #
#                    x*   * * #
# # # # # #*# # #*#*# # # # #*#
# #                           #
#3# # # # # ##  # #*# #*# # # #
#*# #   # # ###               #
# # # # ### ##  #*#*# # # # # #
#*# # **  *                   #
# #*# # # # # # #*# # # # # # #
#   #       *      *          #
###############################
